_ R R _ F4 _ _
_ W R W _ W _
_ _ _ _ _ _ _
_ W _ W _ W _
_ _ _ _ _ _ _
_ W _ W _ W _
_ _ _ _ _ _ _
