_ _ _ _ _ _ _
_ W _ W _ W _
_ _ _ R _ _ _
_ W _ W R W _
_ _ _ _ _ _ _
_ W _ W _ W _
_ _ _ _ _ _ B1
