_ R R _ _ _ _
_ W R W _ W _
_ _ _ _ _ _ _
_ W _ F4 _ W _
_ _ _ R _ _ _
_ W _ _ _ _ _
_ _ _ _ _ _ _
