_ R R _ _ _ _
_ W R W _ W _
_ _ _ _ _ _ _
_ W _ F5 _ W _
_ _ _ R _ _ _
_ W _ S5 _ _ _
_ _ _ _ _ _ _