B2 R R _ FP _ _
_ W R W _ W _
B5 _ _ _ B2 _ _
_ W _ W _ W _
_ _ _ _ _ _ _
_ W _ _ _ W _
_ _ _ _ _ _ _